戦乙女	战乙女
蒼龍	苍龙	name
流	流	name
六式	六式	name
桜火	樱火	name
七式	七式	name
麟	麟	name
朱鳳	朱凤	name
無限	无限	name
黒亀	黑龟	name
玄馬	玄马	name
猫沼	猫沼	name
音子	音子	name
犬羽	犬羽	name
瑠琉	瑠琉	name
グリムゲルデ	格里姆格德	name
ヘルムヴィーゲ	赫尔姆维格	name
ヘルム	赫尔姆	name
グリム	格里姆	name
グリム	加尔姆	name
ヴァルハラ	瓦尔哈拉	地名
ヴァルキリー	瓦尔基里	name
スズキ	铃木	name
ぷらら	普拉拉	name
三式五式改	三式五式改	name
煉獄	炼狱	name
六木	六木	name
マスター	主人
ボクっ娘	仆娘
ダンテ	但丁
アリギエーリ	阿利吉耶里
ウェルギリウス	维吉尔
アンスール	安苏尔
ベオーク	贝奥克
イング	吸收
コンビネーション	组合
アスガルド	阿斯加德
ベルセルク	狂战士
ムスペルヘイム	穆斯贝尔海姆
フレズベルク	赫拉斯瓦尔格
スティガンデ	斯特甘德
オーディン	奥丁
グリンピース	青豆
クチュ	クチュ	拟声词
二輪	二轮
一色	一色
あげは	扬羽
つぐみ	鸫
ガルム	加姆
ディープワンズ	深潜者
テュルフィング	提尔锋
タルンカッペ	塔恩卡佩	
ウルフベルセルク	狂狼战士
ダゴン	大衮
カノ	卡诺
カメラマン	 Cameraman
システム	系统
フレイヤ	弗蕾娅